OOOOOOOOOO
OX     O O
O . OO   O
O O O    O
O OOOO O O
O O      O
O OO  OO O
O O O    U
O O OOOOOO
O . O    O
OOOOOOOOOO
